{
  "levels": [
    {
      "number": 1,
      "title": "Рівень 1",
      "scheme": [
        "#######",
        "#S  #E#",
        "# # # #",
        "# #   #",
        "# ### #",
        "#     #",
        "#######"
      ]
    },
    {
      "number": 2,
      "title": "Рівень 2",
      "scheme": [
        "########",
        "#S #   #",
        "#  # # #",
        "##   # #",
        "#  ### #",
        "#      #",
        "# ####E#",
        "########"
      ]
    },
    {
      "number": 3,
      "title": "Рівень 3",
      "scheme": [
        "#########",
        "#S    #E#",
        "### # # #",
        "#   #   #",
        "# ##### #",
        "# #     #",
        "# # ### #",
        "#     # #",
        "#########"
      ]
    },
    {
      "number": 4,
      "title": "Рівень 4",
      "scheme": [
        "##########",
        "#S   #   #",
        "### # # ##",
        "#   # #  #",
        "# ### ## #",
        "# #      #",
        "# # ######",
        "# #     E#",
        "#   #### #",
        "##########"
      ]
    },
    {
      "number": 5,
      "title": "Рівень 5",
      "scheme": [
        "###########",
        "#S  #     #",
        "### # ### #",
        "#   # #   #",
        "# ### # ###",
        "# #   #   #",
        "# # ##### #",
        "# #     # #",
        "# ##### #E#",
        "#         #",
        "###########"
      ]
    },
    {
      "number": 6,
      "title": "Рівень 6",
      "scheme": [
        "###########",
        "#S  #     #",
        "### # ### #",
        "#   # #   #",
        "# ### # ###",
        "# #   #   #",
        "# # ##### #",
        "# #     # #",
        "# ##### #E#",
        "#         #",
        "###########"
      ]
    },
    {
      "number": 7,
      "title": "Рівень 7",
      "scheme": [
        "###########",
        "#S  #     #",
        "### # ### #",
        "#   # #   #",
        "# ### # ###",
        "# #   #   #",
        "# # ##### #",
        "# #     # #",
        "# ##### #E#",
        "#         #",
        "###########"
      ]
    }

  ]
}
